111111111111111111111111111111
111111111111111111111111111111
111111111111111111111111111111
111111111111111111111111111111
111111111111111111111111111111
111111111111111111111111111111
111111111111111111111111111111
111111111111111111111111111111
111111111111111111111111111111
111111111111114444444444444444
111111111111114444444444444444
111111111111114444444444444444
111111111111114444444444444444
333333333333333333333222222222
333333333333333333333222222222
999999999999999999999999999999
